"","Cause","Adults","Yearlings","Fawns","Total"
"1","Censored",182,28,33,243
"2","Mountain Lion",17,1,11,29
"3","NonPredation",10,0,5,15
"4","Harvest",6,3,0,9
"5","Unknown Predation",6,2,11,19
"6","Unknown Mortality",6,0,3,9
"7","Coyote",5,0,5,10
"8","Wolf",3,0,2,5
"9","Bear",1,0,9,10
"10","Bobcat",0,0,2,2
"11","Total",236,34,81,351
